W,W,W,F,W,W,W
W,T,T,T,T,W,W
W,B,W,W,T,W,W
W,T,T,T,T,T,W
W,B,W,W,W,T,W
W,T,T,T,T,T,W
W,S,W,W,W,W,W
W,W,W,W,W,W,W